S..+...........+......+....+..+......+..++....+.....+++....+....
..++..+.+..........+.+........+.+...+...+++..........+...+..+...
......+.......+.......++..+.+..++..+...+........+...++..+...+.+.
...++.......+..+..+.+..+..+.....+...+.......+........++++.....+.
+..++..++....+.+...+.+..+.+...+.....+......+......+.+.+...+.+..+
...+....+.++...+..+.......+..+......+...+++......+.......+...++.
.....+..+...++++.........+......................+..++...+.++...+
..........+..++..+..+.++...+...+..+...+......+++....+........+..
+...+..++.+.+.+++++.++...+++++++.+.+..+.....+..+.......+.++...+.
.+................+.+....+.+.+......++...+..............++++....
.+..++.....+......+.............+.............+...+....+......++
+..........+.+++..++..+..+.+.......+++........+....+.....+...+..
+..++....+.+.+.+.+++....++.......+.............++....+....++....
+......+.....+............++....+.....+......+++.....+.+..+.....
..+....+...++....+.+....+.....+..+....+++.......+...........++..
...++...+..+.+......++++.++................+..+..++..+.+.+......
+...+........+........+.+...+.+..+...+..+............+...+.+....
......+.++.+..++++++.....+....+..+++.+....+++..+..........+.....
.....+.+.....+.........+..+...++............++..++......+.....+.
.+......+...+........+.+..............+.....+.....+...+......+..
+....+.......+.+........++..+...+++.+..+..+...............+.+...
+.+................+.......+..+...+.+.......+....+.....+...+....
.......++++.+......+...+...............+...+..+....+...+.++.....
+.+...+...+...............++.+++.........++.............++......
..++.+....+...............+........+....++.....++++....+..+.....
+.+...+..........++...+.+.....+++..++..++.....+......+..++......
..+.+....+..........+.+.+..+.......+...........++.+.+.........+.
....+.+..........+........++++..++.+...+..+...+....+..+.........
........+........+..+..+..+.+..+....+...+...............+...++.+
.........+..+.......+...++...+.++.++...+.......+.+..+..++..++...
+++........+....++.........++....+..+.............+.....+.......
.....+++.++...+..+....+.+.....+....+..++.....+.....++......+...+
..+........+...................++....+...+.+....+......+++......
+..+......++...+...+....+.+..+............+....+....+.++....+...
..+.++.......++..+..+....+........+..++.......+....+.+...++...+.
..++..+.+.++.++....+.+....+........+..+++.+....+....+....+......
...+...++..+.+++..........+....+........+..+......+...+....+....
+.............+.+..++.......+..........+......++........+....+..
...++....+.....+.........+....+...+.+.......++...+.+..++...+....
+..+........+.++.....+...+.+..++...+...+.+........+...++.+....+.
..+....+....+.+.....+++...............+.+..+.+..+...+.....+.+...
..+..++......++...+..+....+...+........++.......++...+.+...+....
..++.+......+.......+...............+......+..+.++....+......++.
++.+.+.++.+..+....+.......+++++.........+.++....+.............++
.........+..++.....+.......++......+...+...+.+...++.++++....+...
.++......++.....+...++.........++.+.........+.+..++..++++.+..+++
....+.....+..........+...+..+...+++.....++...+..++.......+.+.+..
.....+........+...++..........+....+...+....+.........+......++.
...+.....+..+...+...+.+.......+..+.+...+..+...+....++.+.........
...+.+.+........+.++..........+.++......+..+++..+.+.....+....+..
+.+.+.........++......+.+..++...+..++..+...++.+.+.+.+.....+.....
+.+++.......++.++++..+.++.++.........+..........+.....+.........
.+.+.......+.+...+.+..+.....+.+....+......+....+...+.......++...
.......+...........+..+..+.+..+...+....+.......+.+....++..+..+..
.....+...+...++.......+++...+..........+......+.+.+..+..+.+....+
..+...........+....++.....+...+.+....++.+..+..+......++++.......
...+......+.++..........+.............+.+..+..+..+........+.+.+.
.....+...++....+.+........+..+.+....+........++++.++.+.......+..
.+.+++.++.+........+..+.+..........++++....+...+.+...++...+...++
+............+......++.+.++......+.+.......+.+.++.+....+......++
++..+.....+...++...+.+.+...+.++.+......+..+..+.............+....
+...++..+++...+...........++...+......+.++..++...+.......++++...
.+...+.+...+.....+..+......+..++......+.+..+.+.....+.+.+.+.++...
...............+...........+..++....+..+.+...++...........+....E