+++++++++++++++++++++++++++++++++++++++++
+S......+...........+...........+......E+
+.+++++.+.+++++.+++.++.+++++.++.+.+++++.+
+.....+.+.....+...+....+.....+..+.+.....+
+++++.+.+++++.+++.+.++.+.+++++.++.+.+++++
+.....+.....+.....+.+..+.....+....+.....+
+.+++++++++.+.+++++.+.++++++.+.++++++++.+
+.+.......+.+.....+.+.....+.+.+......+..+
+.+.+++++.+.+++++.+.+++++.+.+.+.++++.+.++
+.+.+.....+.....+.+.....+.+.+.+.+....+..+
+...+.+++++++++.+.+++++.+.+...+.+.+++++.+
+++.+.+.......+.+.....+.+.+++++.+.....+.+
+...+.+.+++++.+.+++++.+.+.......+.+++.+.+
+.+++.+.+...+.+.....+.+.+++++++++.+.+.+.+
+.....+.+.+.+.+++++.+.+.+.........+.+...+
+.+++++.+.+.+.....+.+.+.+.+++++++++.+++++
+.......+.+.+++++.+...+.+.....+.........+
+.+++++++.+.....+.+++++.+++++.+.+++++++.+
+.+.......+++++.+.....+.....+.+.......+.+
+.+.++++++++....+++++.+.+++.+.+++++++.+++
+.+.........+.........+.+...+.........+.+
+.+++++++++.+.+++++++++.+.+++++++++++++.+
+...........+...........+...............+
+++++++++++++++++++++++++++++++++++++++++
