+++++++++++++++++++++++++++++++++++++++++
+S....+...........+...........+........E+
+.+++.+++++.+++++.+.+++++.+++++.+.+++++.+
+.+...+...+.....+.+.+...+.+.....+.+.....+
+.+.+++.+.+++++.+.+.+.+.+.+.+++++.+.+++++
+.+.....+.....+.+...+.+...+.....+.+.....+
+.+++++++++++.+.+++++.+++++++++.+.+++++.+
+.....+.......+.....+.....+.....+.....+.+
+++++.+.+++++++++++.+++++.+.+++++++++.+.+
+.....+.....+.....+.....+.+.....+.....+.+
+.+++++++++.+.+++.+++++.+.+++++.+.+++++.+
+.+.......+.+...+.....+.+.....+.+.......+
+.+.+++++.+.+++.+.+++.+.+++++.+.+++++++.+
+.+.+.....+...+.+...+.+.....+.+.....+...+
+.+.+.+++++++.+.+++.+.+++++.+.+++++.+.+++
+...+.....+...+.....+.....+...+.....+...+
+.+++++++.+++++++++++++++++++++.+++++++.+
+.......+.....+.....+.....+.....+.......+
+.+++++.+.+++.+.+++.+.+++.+.+++.+.+++++.+
+.....+...+...+...+...+...+...+...+.....+
+++++++++++++++++++++++++++++++++++++++++