+++++++++++++++++++++++++++++++
+S............................+
+.+.+.+.+.+.+.+.+.+.+.+.+.+.+.+
+....++....++....++....++.....+
+.+.+++.+.+++.+.+++.+.+++.+.+.+
+.............................+
+.+.+.+.+.+.+.+.+.+.+.+.+.+.+.+
+....++....++....++....++.....+
+.+.+++.+.+++.+.+++.+.+++.+.+.+
+.............................+
+.+.+.+.+.+.+.+.+.+.+.+.+.+.+.+
+....++....++....++....++.....+
+.+.+++.+.+++.+.+++.+.+++.+.+.+
+.............................+
+.+.+.+.+.+.+.+.+.+.+.+.+.+.+.+
+....++....++....++....++.....+
+.+.+++.+.+++.+.+++.+.+++.+.+.+
+.............................+
+.+.+.+.+.+.+.+.+.+.+.+.+.+.+.+
+............................E+
+++++++++++++++++++++++++++++++