+++++++++++++++++++++++++++++++
+S............................+
+.+.+.+.+.+.+.+.+.+.+.+.+.+.+.+
+.............................+
+.+.+.++.+.+.+.++.+.+.+.++.+.+.
+....++................++.....+
+.+.+.+.+.+.+.+.+.+.+.+.+.+.+.+
+.............................+
+.+.+.+.+.++.+.+.+.+.++.+.+.+.+
+..........++......++.........+
+.+.+.+.+.+.+.+.+.+.+.+.+.+.+.+
+.............................+
+.+.+.++.+.+.+.++.+.+.+.++.+.+.
+....++................++.....+
+.+.+.+.+.+.+.+.+.+.+.+.+.+.+.+
+.............................+
+.+.+.+.+.++.+.+.+.+.++.+.+.+.+
+..........++......++.........+
+.+.+.+.+.+.+.+.+.+.+.+.+.+.+.+
+............................E+
+++++++++++++++++++++++++++++++
