+++++++++++++++++++++++++++++++++++++++++++++++++++++++++++++++++++++++++++++++++
+...............................................................................+
+...............................................................................+
+...............................................................................+
+...............................................................................+
+...............................................................................+
+...............................................................................+
+...............................................................................+
+...............................................................................+
+...............................................................................+
+...............................................................................+
+...............................................................................+
+...............................................+++++++++++++++++++++...........+
+...............................................+...................+...........+
+...............................................+...................+...........+
+...............................................+...................+...........+
+...............................................+...................+...........+
+...............................................+...................+...........+
+...............................................+...................+...........+
+...............................................+...................+...........+
+...S...........................................+.........E.........+...........+
+...............................................+...................+...........+
+...............................................+...................+...........+
+...............................................+...................+...........+
+...............................................+...................+...........+
+...............................................+...................+...........+
+...............................................+...................+...........+
+...............................................+...................+...........+
+...............................................+++++++++++++++++++++...........+
+...............................................................................+
+...............................................................................+
+...............................................................................+
+...............................................................................+
+...............................................................................+
+...............................................................................+
+...............................................................................+
+...............................................................................+
+...............................................................................+
+...............................................................................+
+...............................................................................+
+++++++++++++++++++++++++++++++++++++++++++++++++++++++++++++++++++++++++++++++++
