+++++++++++++++++++++++++++++++++++++++++++++++++++++++++++++++++++
+++++++++++++++++++++++++++++++++++++++++++++++++++++++++++++++++++
+++++++++++++++++++++++++++++++++++++++++++++++++++++++++++++++++++
+++++++++++++++++++++++++++++++++++++++++++++++++++++++++++++++++++
+++++++++++++++++++++++++++++++++++++++++++++++++++++++++++++++++++
+.................................................................+
+.................................................................+
+.................................................................+
++++++++++...............................................++++++++++
++++++++++..++++++.............................++++++....++++++++++
++++++++++..++++++.......++++++................++++++....++++++++++
++++++++++..++++++.......++++++................++++++....++++++++++
++++++++++..++++++.......++++++................++++++....++++++++++
+........+..++++++.......++++++................++++++....+........+
+........+..++++++.......++++++................++++++....+........+
+........+...............++++++..........................+........+
+........+...............++++++..........................+........+
+.................................................................+
+...S.................+++++.............+++++.................E...+
+.................................................................+
+........+.........................++++++................+........+
+........+.........................++++++................+........+
+........+....++++++...............++++++........++++++..+........+
+........+....++++++...............++++++........++++++..+........+
++++++++++....++++++...............++++++........++++++..++++++++++
++++++++++....++++++...............++++++........++++++..++++++++++
++++++++++....++++++...............++++++........++++++..++++++++++
++++++++++....++++++.............................++++++..++++++++++
++++++++++...............................................++++++++++
+.................................................................+
+.................................................................+
+.................................................................+
+++++++++++++++++++++++++++++++++++++++++++++++++++++++++++++++++++
+++++++++++++++++++++++++++++++++++++++++++++++++++++++++++++++++++
+++++++++++++++++++++++++++++++++++++++++++++++++++++++++++++++++++
+++++++++++++++++++++++++++++++++++++++++++++++++++++++++++++++++++
+++++++++++++++++++++++++++++++++++++++++++++++++++++++++++++++++++
