+++++++++++++++++++++++++++++++++++++++++++++++++++++++++++++++++++
+++++++++++++++++++++++++++++++++++++++++++++++++++++++++++++++++++
+++++++++++++++++++++++++++++++++++++++++++++++++++++++++++++++++++
+++++++++++++++++++++++++++++++++++++++++++++++++++++++++++++++++++
+++++++++++++++++++++++++++++++++++++++++++++++++++++++++++++++++++
+.................................................................+
+.................................................................+
+.................................................................+
+++++++++++++++++...+++++++++++++++++...+++++++++++++++++++++++++++
+++++++++++++++++...+++++++++++++++++...+++++++++++++++++++++++++++
+++++++++++.....+...+.....+++++.....+...+.....+++++.....+++++++++++
+++++++++++.+++.+...+.....+++++.+++.+...+.....+++++.+++.+++++++++++
+++++++++++.+++.+...+.....+++++.+++.+...+.....+++++.+++.+++++++++++
+++++++++++.+++.+...+.....+++++.+++.+...+.....+++++.+++.+++++++++++
+.........+.+++.+...+.....+++++.+++.+...+.....+++++.+++.+.........+
+.........+.+++.+...+.....+++++.+++.+...+.....+++++.+++.+.........+
+.........+.....+...+.....+++++.....+...+.....+++++.....+.........+
+.................................................................+
+...S.........................................................E...+
+.................................................................+
+.........+.....+++++.....+...+.....+++++.....+...+.....+.........+
+.........+.....+++++.+++.+...+.....+++++.+++.+...+.....+.........+
+.........+.....+++++.+++.+...+.....+++++.+++.+...+.....+.........+
+++++++++++.....+++++.+++.+...+.....+++++.+++.+...+.....+++++++++++
+++++++++++.....+++++.+++.+...+.....+++++.+++.+...+.....+++++++++++
+++++++++++.....+++++.+++.+...+.....+++++.+++.+...+.....+++++++++++
+++++++++++.....+++++.....+...+.....+++++.....+...+.....+++++++++++
+++++++++++++++++++++++++++...+++++++++++++++++...+++++++++++++++++
+++++++++++++++++++++++++++...+++++++++++++++++...+++++++++++++++++
+.................................................................+
+.................................................................+
+.................................................................+
+++++++++++++++++++++++++++++++++++++++++++++++++++++++++++++++++++
+++++++++++++++++++++++++++++++++++++++++++++++++++++++++++++++++++
+++++++++++++++++++++++++++++++++++++++++++++++++++++++++++++++++++
+++++++++++++++++++++++++++++++++++++++++++++++++++++++++++++++++++
+++++++++++++++++++++++++++++++++++++++++++++++++++++++++++++++++++