+++++++++++++++++++++++++++++++++++++++++++++++++++++++++++++
+...........................................................+
+..................+........................................+
+....+.............+........................................+
+....+.............+........................................+
+....+.............+........................................+
+....+.............+........................................+
+....+.............+........................................+
+....+.............+........................................+
+....+.............+........................................+
+S...+.............+.......................................E+
+....+.............+........................................+
+....+.............+........................................+
+....+.............+........................................+
+....+.............+........................................+
+....+.............+........................................+
+....+.............+........................................+
+....+.............+........................................+
+..................+........................................+
+...........................................................+
+++++++++++++++++++++++++++++++++++++++++++++++++++++++++++++
