+++++++++++++++++++++++++++++++++++++++++++++++++++++++++++++
+...........................................................+
+...........++++++++........................................+
+....+.............+........................................+
+....+.............+........................................+
+....+.............+........................................+
+....+.............+........................................+
+....+.............+........................................+
+....+.............+........................................+
+....+.............+........................................+
+S...+.............+.......................................E+
+....+.............+........................................+
+....+.............+........................................+
+....+.............+........................................+
+....+.............+........................................+
+....+.............+........................................+
+....+.............+........................................+
+....+.............+........................................+
+...........++++++++........................................+
+...........................................................+
+++++++++++++++++++++++++++++++++++++++++++++++++++++++++++++
