+++++++++++++++++++++++++++++++++++++++++++++++++++++++++++++++++++++++++++++++++
+...............................................................................+
+...............................................................................+
+...............................................................................+
+...............................................................................+
+...............................................................................+
+...............................................................................+
+...............................................................................+
+.................................++++++....+++++++++++++++++++++++++++++++.....+
+.................................+.......................................+.....+
+.................................+.......................................+.....+
+.................................+.......................................+.....+
+.................................+.....+++++++++++++++++++++++++++++.....+.....+
+.................................+.....+...........................+.....+.....+
+.................................+.....+...........................+.....+.....+
+.................................+.....+...........................+.....+.....+
+.................................+.....+.....++++....+++++++++.....+.....+.....+
+.................................+.....+.....+...............+.....+.....+.....+
+.................................+.....+.....+...+++++++++...+.....+.....+.....+
+.................................+.....+.....+...+...........+.....+.....+.....+
+..S..............................+.....+.....+...+...E.......+.....+.....+.....+
+.................................+.....+.....+...+...........+.....+.....+.....+
+.................................+.....+.....+...+++++++++...+.....+.....+.....+
+.................................+.....+.....+...............+.....+.....+.....+
+.................................+.....+.....+++++++++++++++++.....+.....+.....+
+.................................+.....+...........................+.....+.....+
+.................................+.....+...........................+.....+.....+
+.................................+.....+...........................+.....+.....+
+.................................+.....++++++++++++++++++....+++++++.....+.....+
+.................................+.......................................+.....+
+.................................+.......................................+.....+
+.................................+.......................................+.....+
+.................................+++++++++++++++++++++++++++++++++++++++++.....+
+...............................................................................+
+...............................................................................+
+...............................................................................+
+...............................................................................+
+...............................................................................+
+...............................................................................+
+...............................................................................+
+++++++++++++++++++++++++++++++++++++++++++++++++++++++++++++++++++++++++++++++++
