++++++++++++
+..........+
+....+++++.+
+....+...+.+
+....+...+.+
+....+.+.+.+
+....+.+.+.+
+S...+.+.+.+
+....+.+.+.+
+....+.+.+.+
+....+.+E+.+
+....+.+++.+
+....+.....+
++++++++++++

